111111111111111111111
1P11E0000000000000001
100100000000000000001
100101111111101111111
10010111C000000000001
100101111111111111111
100100000000000000001
101111111111111110001
101111111111111110001
101111111111111110001
101111111100011110001
100000000001000000001
111111111111111111111