1111111
100E001
1C01111
1000P01
1111111
