111111111111111111111111
1C00000000000000000000C1
100000001100011011100001
1000000110MM010011100001
100000110000000111000001
10000110000E001110000001
100011000000P11100M00001
100111111110011100100001
100000001110011101100001
10000000111MM00000000001
1C00000000000000000000C1
111111111111111111111111
