1111111
100E001
1C01111
1010P0
1111111
