111111111111111
10P111000000001
101111000000001
1C1000000000001
101000000000001
101000000000001
10100C000000001
11E000000000001
111111111111111
111111111111111